SS             SS  S
  S S S  S S  S     
        S   S  SS S 
XXXXD         S     
  S X   S  S      S 
  SXRXXXXXXXXXXXD   
  S X X         X  S
    S S        DL S 
         WXXXXXLX S 
   S   S          SS
     S S        S S 
 S   S    SS    S S 
  SSS    S   S      
 S   S          SS  
 S S S  S  S  SS SS 
 S   S         S SS 
 SSSSS     S   S  S 
 SS SS  S      SSSS 
      S    S   S  SS
             S      
