      S       S X SS
  S        S    X   
S  S   S    S   X   
  S  S    S   S X  S
             S  X   
     S  S XXXXXXDXXX
S S       X     X S 
     S S SX  S DL   
      DXXXLXXXXLX   
   S  XS  X        S
  S   X   X    S    
      X   X S       
 S  S X  SX     S  S
      W   X  S      
          X  S  S   
     S    X         
  S       X S     S 
      RXXXUXXXL     
      X       X S   
      X S  S  X     
