S   S    X   S    SS
 SS S S  X S   S SSS
 S   S  SX S S   SSS
XXXXD S  X S SS   SS
 S  X X  X   S    SS
   XRXXXXRXXXXXXD  S
  S   X     S   X  S
   S  XS  S    DLS  
      S   DXXXXLL   
    S  S  X S       
 S        X  S  S SS
      S   X  S   S S
          X    S    
          XS        
   WXXXXXXL      S  
              S  S  
                  S 
  S      S S    S   
     S  SS  S  S S S
                 SS 
